1 1 1 1 1 1 1 1 1 1 1 1 1 1 1 1 1 1 1 1 1 1 1 1 1 1 1 1 1 1 1 1 1 1 1 1 1 1 1 1 1 1 1 1 1 1 1 1 1 1 1 1 1 1 1 1 1 1 1 1 1 1 1 1 1 1 1 1 1 1 1 1 1 1 1 1 1 1 1 1 1 1 1 1 1 1 1 1 1 1 1 1 1 1 1 1 1 1 1 1
1 1 1 1 1 1 1 1 1 1 1 1 1 1 1 1 1 1 1 1 1 1 1 1 1 1 1 1 1 1 1 1 1 1 1 1 1 1 1 1 1 1 1 1 1 1 1 1 1 1 1 1 1 1 1 1 1 1 1 1 1 1 1 1 1 1 1 1 1 1 1 1 1 1 1 1 1 1 1 1 1 1 1 1 1 1 1 1 1 1 1 1 1 1 1 1 1 1 1 1
1 1 1 1 1 1 1 1 1 1 1 1 1 1 1 1 1 1 1 1 1 1 1 1 1 1 1 1 1 1 1 1 1 1 1 1 1 1 1 1 1 1 1 1 1 1 1 1 1 1 1 1 1 1 1 1 1 1 1 1 1 1 1 1 1 1 1 1 1 1 1 1 1 1 1 1 1 1 1 1 1 1 1 1 1 1 1 1 1 1 1 1 1 1 1 1 1 1 1 1
1 1 1 1 1 1 1 1 1 1 1 1 1 1 1 1 1 1 1 1 1 1 1 1 1 1 1 1 1 1 1 1 1 1 1 1 1 1 1 1 1 1 1 1 1 1 1 1 1 1 1 1 1 1 1 1 1 1 1 1 1 1 1 1 1 1 1 1 1 1 1 1 1 1 1 1 1 1 1 1 1 1 1 1 1 1 1 1 1 1 1 1 1 1 1 1 1 1 1 1
1 1 1 1 1 1 1 1 1 1 1 1 1 1 1 1 1 1 1 1 1 1 1 1 1 1 1 1 1 1 1 1 1 1 1 1 1 1 1 1 1 1 1 1 1 1 1 1 1 1 1 1 1 1 1 1 1 1 1 1 1 1 1 1 1 1 1 1 1 1 1 1 1 1 1 1 1 1 1 1 1 1 1 1 1 1 1 1 1 1 1 1 1 1 1 1 1 1 1 1
1 1 1 1 1 1 1 1 1 1 1 1 1 1 1 1 1 1 1 1 1 1 1 1 1 1 1 1 1 1 1 1 1 1 1 1 1 1 1 1 1 1 1 1 1 1 1 1 1 1 1 1 1 1 1 1 1 1 1 1 1 1 1 1 1 1 1 1 1 1 1 1 1 1 1 1 1 1 1 1 1 1 1 1 1 1 1 1 1 1 1 1 1 1 1 1 1 1 1 1
1 1 1 1 1 1 1 1 1 1 1 1 1 1 1 1 1 1 1 1 1 1 1 1 1 1 1 1 1 1 1 1 1 1 1 1 1 1 1 1 1 1 1 1 1 1 1 1 1 1 1 1 1 1 1 1 1 1 1 1 1 1 1 1 1 1 1 1 1 1 1 1 1 1 1 1 1 1 1 1 1 1 1 1 1 1 1 1 1 1 1 1 1 1 1 1 1 1 1 1
1 1 1 1 1 1 1 1 1 1 1 1 1 1 1 1 1 1 1 1 1 1 1 1 1 1 1 1 1 1 1 1 1 1 1 1 1 1 1 1 2 2 1 1 1 1 1 1 1 1 1 1 1 1 2 2 1 1 2 1 1 1 1 1 1 1 1 1 1 1 1 1 1 1 1 1 1 1 1 1 1 1 1 1 1 1 1 1 1 1 1 1 1 1 1 1 1 1 1 1
1 1 1 1 1 1 1 1 1 1 1 1 1 1 1 1 1 1 1 1 1 1 1 1 1 1 1 1 1 1 1 1 1 1 1 1 1 1 1 1 1 1 1 1 1 1 2 1 2 1 2 1 1 2 1 1 1 2 1 1 1 1 1 1 1 1 1 1 1 1 1 1 1 1 1 1 1 1 1 1 1 1 1 1 1 1 1 1 1 1 1 1 1 1 1 1 1 1 1 1
1 1 1 1 1 1 1 1 1 1 1 1 1 1 1 1 1 1 1 1 1 1 1 1 1 1 1 1 1 1 1 1 2 1 1 1 1 1 2 1 2 1 1 1 1 2 2 2 2 2 2 1 1 2 2 2 1 1 2 1 1 1 2 1 1 1 1 1 1 1 1 2 1 1 1 1 1 1 1 1 1 1 1 1 1 1 1 1 1 1 1 1 1 1 1 1 1 1 1 1
1 1 1 1 1 1 1 1 1 1 1 1 1 1 1 1 1 1 1 1 1 1 1 1 1 1 1 2 1 2 1 1 2 1 1 1 2 2 1 1 1 1 2 2 1 1 1 2 2 2 7 7 1 2 1 1 1 2 1 2 1 1 1 1 2 1 2 2 1 1 1 1 1 2 1 1 1 1 1 1 1 1 1 1 1 1 1 1 1 1 1 1 1 1 1 1 1 1 1 1
1 1 1 1 1 1 1 1 1 1 1 1 1 1 1 1 1 1 1 1 1 1 1 1 1 1 1 1 1 1 1 1 2 1 2 1 2 2 2 1 2 2 2 1 1 1 2 1 1 1 7 7 2 2 2 2 2 1 1 2 1 1 1 2 1 2 1 1 2 2 1 2 1 1 1 1 2 1 1 1 1 1 1 1 1 1 1 1 1 1 1 1 1 1 1 1 1 1 1 1
1 1 1 1 1 1 1 1 1 1 1 1 1 1 1 1 1 1 1 1 1 1 1 1 1 1 1 1 2 2 1 2 1 2 1 2 2 1 2 2 2 1 2 2 2 2 1 2 1 2 1 1 2 2 1 2 2 2 1 2 2 1 1 2 2 1 1 1 1 1 1 2 1 1 1 2 1 1 1 1 1 1 1 1 1 1 1 1 1 1 1 1 1 1 1 1 1 1 1 1
1 1 1 1 1 1 1 1 1 1 1 1 1 1 1 1 1 1 1 1 1 1 1 1 2 1 1 2 1 2 1 2 2 2 2 1 2 2 1 1 2 0 1 2 1 1 1 2 2 1 7 7 2 2 1 1 0 2 2 1 2 2 1 2 2 2 1 2 1 1 2 2 1 1 2 2 1 2 1 1 1 1 1 1 1 1 1 1 1 1 1 1 1 1 1 1 1 1 1 1
1 1 1 1 1 1 1 1 1 1 1 1 1 1 1 1 1 1 1 1 1 1 2 2 1 2 1 1 2 2 1 2 2 1 2 1 1 1 1 2 1 0 2 2 2 1 0 2 0 0 7 7 2 2 0 2 6 2 2 2 1 2 2 1 1 2 1 1 1 1 2 2 2 1 1 1 2 1 2 2 1 1 1 1 1 1 1 1 1 1 1 1 1 1 1 1 1 1 1 1
1 1 1 1 1 1 1 1 1 1 1 1 1 1 1 1 1 1 1 1 1 1 1 1 1 1 2 2 1 2 2 1 1 1 2 2 2 1 2 2 2 2 1 1 2 1 2 2 2 6 7 7 2 2 2 2 0 1 2 0 2 2 1 2 2 0 2 2 1 2 2 2 2 1 1 2 1 1 1 2 1 1 1 1 1 1 1 1 1 1 1 1 1 1 1 1 1 1 1 1
1 1 1 1 1 1 1 1 1 1 1 1 1 1 1 1 1 1 1 1 2 1 1 1 2 2 2 2 2 1 2 1 1 2 2 2 6 1 2 2 0 2 2 2 2 6 0 2 0 2 7 7 2 2 2 2 6 2 2 1 2 2 0 2 2 2 2 2 2 1 2 2 2 1 1 2 1 2 2 1 1 1 1 1 1 1 1 1 1 1 1 1 1 1 1 1 1 1 1 1
1 1 1 1 1 1 1 1 1 1 1 1 1 1 1 1 1 1 1 1 1 1 1 1 1 2 1 2 1 2 1 2 0 2 2 2 2 2 6 2 0 0 2 2 6 2 2 0 0 2 7 7 2 2 2 2 2 0 2 2 2 0 2 2 2 0 2 0 2 2 1 2 2 1 2 1 1 2 2 1 1 2 2 2 1 2 1 1 1 1 1 1 1 1 1 1 1 1 1 1
1 1 1 1 1 1 1 1 1 1 1 1 1 1 1 1 1 1 1 1 1 1 2 1 1 1 2 1 2 0 0 2 2 1 2 2 2 2 2 2 0 6 0 2 2 2 0 0 0 2 7 7 0 0 6 2 2 2 2 2 2 0 2 2 0 0 0 0 2 2 1 1 2 2 2 1 1 1 1 1 2 1 2 1 1 1 1 1 1 1 1 1 1 1 1 1 1 1 1 1
1 1 1 1 1 1 1 1 1 1 1 1 1 1 1 1 1 2 2 1 1 2 2 2 2 1 2 2 0 2 2 2 0 2 2 2 0 2 2 2 2 6 0 0 0 0 2 0 6 0 7 7 0 0 2 2 0 2 0 2 2 2 0 0 2 2 2 2 2 2 0 2 2 2 1 1 2 1 1 1 2 2 2 1 1 1 1 1 1 1 1 1 1 1 1 1 1 1 1 1
1 1 1 1 1 1 1 1 1 1 1 1 1 1 1 1 1 1 1 1 2 1 2 1 2 2 2 0 2 0 1 0 2 0 2 0 0 2 2 0 0 2 0 0 0 0 2 0 6 2 7 7 0 0 0 2 0 2 2 2 2 2 0 0 2 2 0 2 2 2 2 2 2 2 2 2 2 1 1 1 1 1 2 2 2 1 1 1 2 1 1 1 1 1 1 1 1 1 1 1
1 1 1 1 1 1 1 1 1 1 1 1 1 1 1 2 1 1 2 2 1 2 1 1 0 2 2 2 2 2 2 0 2 2 2 6 0 6 2 0 2 2 2 6 0 2 0 2 2 0 7 7 0 2 0 0 0 0 2 0 0 0 0 6 0 2 0 6 2 0 2 2 2 2 0 1 2 2 2 1 1 2 2 1 2 1 1 1 1 1 1 1 1 1 1 1 1 1 1 1
1 1 1 1 1 1 1 1 1 1 1 1 1 1 1 2 2 1 1 2 2 2 2 2 2 2 2 2 2 2 2 2 2 0 2 2 0 2 2 2 0 0 2 0 6 0 0 0 0 0 7 7 0 0 2 0 0 2 0 0 0 0 0 0 2 2 0 0 2 2 0 2 0 2 6 0 0 1 0 2 2 2 2 1 1 1 1 1 1 1 1 1 1 1 1 1 1 1 1 1
1 1 1 1 1 1 1 1 1 1 1 1 1 2 1 2 1 2 1 1 1 1 2 2 1 2 2 6 2 0 2 2 2 0 2 0 0 0 2 6 0 0 6 0 0 0 0 0 0 0 7 7 0 0 0 0 0 0 0 2 2 0 0 6 0 6 2 2 2 2 0 6 0 0 2 6 2 1 2 2 2 2 2 2 2 1 1 1 1 1 1 1 1 1 1 1 1 1 1 1
1 1 1 1 1 1 1 1 1 1 1 1 1 2 1 2 2 2 2 2 2 2 2 2 0 0 0 2 0 2 0 0 0 0 2 0 0 6 0 2 0 2 0 0 0 0 0 0 0 0 7 7 0 0 6 0 0 0 6 0 0 0 0 2 2 0 2 2 0 0 2 2 0 2 2 2 0 2 1 1 0 2 2 2 1 1 2 2 1 1 1 1 1 1 1 1 1 1 1 1
1 1 1 1 1 1 1 1 1 1 1 1 1 1 2 2 1 2 2 0 2 2 2 0 2 2 0 2 0 0 0 6 0 0 0 0 0 0 0 0 0 6 0 0 0 6 0 0 0 6 7 7 0 0 6 0 0 6 0 0 0 0 6 2 0 0 0 2 0 6 2 2 0 2 2 5 5 5 1 5 5 1 1 5 7 1 2 1 2 1 1 1 1 1 1 1 1 1 1 1
1 1 1 1 1 1 1 1 1 1 1 1 1 1 1 1 1 2 2 2 1 0 0 2 2 2 0 6 0 2 2 0 0 0 0 0 0 0 0 0 0 0 6 6 0 0 6 0 0 0 7 7 0 0 6 6 0 0 0 6 6 0 0 6 6 0 0 2 0 0 0 2 0 2 2 5 5 7 5 7 1 7 5 7 1 2 2 1 1 1 1 1 1 1 1 1 1 1 1 1
1 1 1 1 1 1 1 1 1 1 1 1 1 2 2 2 2 2 2 2 2 1 2 2 0 0 0 0 0 6 0 0 2 6 6 0 6 6 0 0 0 0 0 6 0 0 0 0 0 0 7 7 0 0 0 6 6 0 0 6 6 0 0 0 0 0 0 0 0 0 6 0 0 0 2 5 7 5 7 5 7 5 7 5 5 2 1 2 2 1 1 1 1 1 1 1 1 1 1 1
1 1 1 1 1 1 1 1 1 1 1 2 2 1 2 2 2 1 2 2 0 0 2 0 0 2 0 0 0 6 0 0 0 0 0 6 0 6 0 0 0 0 0 6 6 0 0 6 0 0 7 7 0 6 6 6 6 0 0 0 0 0 0 0 0 0 6 0 0 0 0 2 0 0 0 7 5 7 5 7 5 7 5 1 5 1 2 1 1 1 1 1 1 1 1 1 1 1 1 1
1 1 1 1 1 1 1 1 1 1 1 2 2 2 2 2 1 2 0 2 0 6 2 2 0 6 0 2 2 0 0 0 6 0 0 6 0 6 0 0 0 0 0 0 6 0 0 0 6 6 7 7 0 0 0 0 0 6 0 0 6 0 0 0 0 6 0 0 0 0 0 0 2 2 0 5 7 5 7 5 7 5 7 5 7 1 2 1 2 1 1 1 1 1 1 1 1 1 1 1
1 1 1 1 1 1 1 1 1 1 1 2 1 2 1 2 2 2 2 0 2 2 2 0 0 2 0 0 0 0 0 0 0 0 0 0 0 0 0 0 0 6 0 6 6 0 0 6 0 0 7 7 0 0 6 0 0 0 0 0 0 0 6 0 0 0 0 0 0 6 6 0 2 6 6 5 5 7 5 7 5 7 5 7 5 2 2 2 2 1 1 1 1 1 1 1 1 1 1 1
1 1 1 1 1 1 1 1 1 1 1 2 2 2 2 2 2 2 0 0 2 0 6 2 6 2 6 0 6 0 0 6 0 0 0 6 0 6 0 0 0 0 0 0 0 0 6 0 0 6 7 7 0 0 6 0 0 0 0 0 0 0 0 0 0 0 0 0 0 6 0 0 0 0 0 5 7 5 7 5 7 5 7 5 7 2 2 2 2 1 1 1 1 1 1 1 1 1 1 1
1 1 1 1 1 1 1 1 1 1 1 1 1 2 2 2 2 2 6 2 6 2 2 0 2 2 0 0 0 0 0 0 0 0 0 0 0 0 6 0 0 6 6 0 0 0 0 0 0 6 7 7 6 0 6 0 0 6 0 0 6 0 0 0 0 6 0 0 0 0 0 0 0 2 0 7 5 7 5 7 5 7 5 7 5 2 2 2 1 1 1 1 1 1 1 1 1 1 1 1
1 1 1 1 1 1 1 1 1 1 1 2 2 1 0 2 2 2 2 2 0 2 0 2 0 0 0 6 0 0 0 0 0 0 0 0 6 0 6 0 6 0 6 0 0 0 6 0 0 7 7 7 0 0 6 0 6 0 6 0 6 0 0 0 0 0 0 0 0 0 0 6 0 6 0 5 7 5 7 5 7 5 7 5 5 2 1 2 2 1 1 1 1 1 1 1 1 1 1 1
1 1 1 1 1 1 1 1 1 1 1 2 2 2 2 2 2 2 0 0 0 0 3 3 3 3 3 3 3 0 0 0 0 6 0 0 0 0 6 0 0 0 6 0 0 0 0 0 6 7 7 7 6 6 0 0 0 0 0 6 0 0 6 0 0 0 0 0 6 0 6 0 6 0 0 5 5 7 5 5 5 7 5 5 5 1 2 2 2 1 1 1 1 1 1 1 1 1 1 1
1 1 1 1 1 1 1 1 1 1 1 2 1 1 2 2 6 2 2 2 2 0 3 4 4 4 4 4 3 0 0 0 0 0 0 0 0 6 0 0 6 0 6 0 6 0 0 0 0 7 7 7 0 6 0 0 0 0 0 0 0 0 0 6 0 0 0 0 6 0 0 0 6 0 0 0 0 2 0 0 2 2 6 2 2 0 2 2 2 1 1 1 1 1 1 1 1 1 1 1
1 1 1 1 1 1 1 1 1 1 1 1 1 2 1 2 2 2 0 0 0 0 3 4 4 4 4 4 3 0 0 6 0 6 0 0 0 0 6 0 0 6 0 0 0 0 0 6 0 7 7 7 0 0 0 0 0 0 0 0 0 6 0 0 0 0 6 6 0 0 6 0 0 6 0 0 0 6 0 0 0 2 0 0 0 2 2 2 2 1 1 1 1 1 1 1 1 1 1 1
1 1 1 1 1 1 1 1 1 1 1 2 2 2 6 0 0 2 6 2 0 0 3 4 4 4 4 4 3 0 0 6 0 0 6 6 0 0 0 0 0 0 6 0 0 0 6 6 0 7 7 7 6 0 6 0 0 0 0 0 0 0 0 6 0 0 0 0 0 0 0 0 0 0 0 0 6 0 0 0 0 0 6 2 2 2 2 2 2 1 1 1 1 1 1 1 1 1 1 1
1 1 1 1 1 1 1 1 1 1 1 2 2 2 2 2 0 2 0 0 6 0 3 4 4 4 4 4 3 0 0 0 0 0 0 0 0 0 0 0 0 0 0 0 0 0 0 0 6 7 7 7 0 0 0 6 0 0 0 0 3 3 3 3 3 3 3 6 6 0 0 0 6 0 6 0 6 0 0 6 0 0 6 2 0 0 0 0 2 1 1 1 1 1 1 1 1 1 1 1
1 1 1 1 1 1 1 1 1 1 1 2 2 2 0 2 2 2 0 2 2 0 3 3 3 4 3 3 3 0 0 0 0 0 0 0 0 0 0 0 6 6 0 0 0 0 0 0 0 7 7 7 0 6 6 0 6 0 0 0 3 4 4 4 4 4 3 6 0 0 6 6 0 0 0 0 0 0 0 2 0 2 2 0 2 0 0 0 2 1 1 1 1 1 1 1 1 1 1 1
1 1 1 1 1 1 1 1 1 1 1 1 0 2 2 0 6 2 0 2 6 0 0 0 0 7 0 0 6 0 6 6 0 0 0 6 0 0 0 0 0 6 0 0 0 0 0 0 0 7 7 7 0 0 0 6 6 0 0 0 3 4 4 4 4 4 3 0 0 0 6 0 0 6 0 6 6 6 0 2 6 2 0 0 0 2 0 2 2 1 1 1 1 1 1 1 1 1 1 1
1 1 1 1 1 1 1 1 1 1 1 2 2 2 2 2 0 6 0 0 0 6 0 0 0 7 0 0 6 0 0 0 0 0 0 0 0 0 0 0 0 0 0 0 0 0 0 0 6 7 7 7 0 0 0 0 0 0 0 0 3 4 4 4 4 4 3 0 6 6 0 0 6 0 0 0 0 0 0 0 0 2 2 2 2 2 6 2 0 1 1 1 1 1 1 1 1 1 1 1
1 1 1 1 1 1 1 1 1 1 1 2 2 2 6 0 0 0 2 0 0 0 0 0 0 7 0 0 6 0 0 0 0 0 6 0 6 6 6 0 0 0 0 0 6 6 0 0 0 7 7 7 0 0 0 0 0 0 0 0 3 3 3 4 3 3 3 0 0 0 0 0 0 6 0 0 0 0 0 0 0 6 0 6 0 2 2 2 0 1 1 1 1 1 1 1 1 1 1 1
1 1 1 1 1 1 1 1 1 1 1 2 2 2 6 0 2 2 2 6 0 0 0 0 0 7 6 0 6 0 0 0 0 0 0 0 0 0 0 0 0 6 0 0 0 0 0 0 0 7 7 7 0 0 0 0 0 0 0 0 3 4 4 4 4 4 3 0 0 6 0 0 0 0 0 0 6 6 0 6 0 0 0 6 2 2 0 2 0 1 1 1 1 1 1 1 1 1 1 1
1 1 1 1 1 1 1 1 1 1 1 2 2 0 2 0 2 0 6 6 0 2 0 0 0 7 0 0 6 0 6 0 0 0 0 0 6 0 6 0 6 0 0 0 6 0 0 0 0 7 7 7 0 0 0 0 6 6 0 0 3 4 4 4 4 4 3 0 0 0 0 0 0 0 6 0 6 0 0 0 0 0 0 2 0 2 2 6 2 1 1 1 1 1 1 1 1 1 1 1
1 1 1 1 1 1 1 1 1 1 1 0 0 2 0 0 0 2 0 6 0 0 0 0 6 7 0 0 0 0 0 0 0 0 0 0 0 0 6 0 0 0 0 0 0 0 0 0 0 7 7 7 6 0 0 0 0 0 0 0 3 4 4 4 4 4 3 0 0 0 0 0 0 6 0 0 0 0 0 0 6 0 0 0 0 2 2 2 2 1 1 1 1 1 1 1 1 1 1 1
1 1 1 1 1 1 1 1 1 1 1 1 2 2 2 2 6 0 2 6 0 0 6 0 6 7 0 0 0 0 0 0 0 0 0 0 6 0 0 0 0 0 6 0 0 0 0 6 6 7 7 7 0 0 0 6 0 0 0 0 3 3 3 4 3 3 3 6 0 6 0 0 0 0 0 0 0 0 0 6 2 0 2 6 0 0 0 2 2 1 1 1 1 1 1 1 1 1 1 1
1 1 1 1 1 1 1 1 1 1 1 2 2 0 2 0 0 2 2 0 6 0 0 0 6 7 0 0 0 6 0 0 0 0 0 0 0 6 0 0 6 0 0 0 0 0 0 6 0 7 7 7 0 0 0 0 6 6 0 6 0 0 0 7 0 0 0 0 0 0 0 0 6 0 0 6 0 0 0 0 6 0 0 2 2 0 0 2 2 1 1 1 1 1 1 1 1 1 1 1
1 1 1 1 1 1 1 1 1 1 1 4 2 0 2 2 0 6 2 6 6 0 6 0 0 7 6 0 0 0 0 0 0 6 0 0 0 0 0 0 0 0 0 0 6 6 0 0 0 7 7 7 0 0 0 0 0 0 0 0 0 6 0 7 6 0 0 0 0 0 0 6 0 0 0 0 0 0 0 0 0 0 2 2 0 2 0 0 0 1 1 1 1 1 1 1 1 1 1 1
1 1 1 1 1 1 1 1 1 1 3 4 4 6 2 0 2 0 0 0 0 6 6 6 0 7 6 0 6 7 7 7 7 7 7 7 7 7 7 7 7 7 7 7 7 7 7 7 7 7 7 7 7 7 7 7 7 7 7 7 7 7 7 7 7 7 7 7 7 7 7 7 7 7 7 7 7 7 7 7 6 0 6 0 0 2 0 2 2 1 1 1 1 1 1 1 1 1 1 1
1 1 1 1 1 1 1 1 1 1 3 4 4 4 4 4 7 7 7 7 7 7 7 7 7 7 7 7 7 7 7 7 7 7 7 7 7 7 7 7 7 7 7 7 7 7 7 7 7 7 7 7 7 7 7 7 7 7 7 7 7 7 7 7 7 7 7 7 7 7 7 7 7 7 7 7 7 7 7 7 7 7 7 7 7 2 2 2 0 1 1 1 1 1 1 1 1 1 1 1
1 1 1 1 1 1 1 1 1 1 3 4 4 4 4 4 7 7 7 7 7 7 7 7 7 7 7 7 7 7 7 7 7 7 7 7 7 7 7 7 7 7 7 7 7 7 7 7 7 7 7 7 7 7 7 7 7 7 7 7 7 7 7 7 7 7 7 7 7 7 7 7 7 7 7 7 7 7 7 7 7 7 7 7 7 6 0 2 6 1 1 1 1 1 1 1 1 1 1 1
1 1 1 1 1 1 1 1 1 1 3 4 4 2 0 2 0 0 0 0 0 0 0 0 6 6 0 0 0 0 0 0 0 6 6 6 0 0 0 6 0 0 0 0 0 0 6 0 0 7 7 7 0 0 0 0 0 0 6 0 0 6 0 0 6 0 0 0 0 0 0 6 6 0 0 6 6 0 6 0 0 0 6 0 6 6 2 2 2 1 1 1 1 1 1 1 1 1 1 1
1 1 1 1 1 1 1 1 1 1 1 2 2 0 2 0 2 6 2 0 0 0 0 0 0 6 0 6 0 0 0 0 0 0 0 0 0 0 0 0 0 0 0 0 0 0 0 0 6 7 7 7 0 0 6 6 0 0 0 0 0 0 6 0 6 6 6 0 0 0 0 0 6 0 0 6 0 6 6 0 2 0 2 0 0 0 0 2 0 1 1 1 1 1 1 1 1 1 1 1
1 1 1 1 1 1 1 1 1 1 1 2 2 0 2 0 0 0 6 6 0 0 6 0 0 0 0 0 6 0 0 0 6 0 0 0 6 0 0 0 0 0 0 6 0 0 0 0 6 7 7 7 0 0 6 0 0 0 6 0 0 6 0 0 0 0 0 0 0 0 0 0 0 0 0 6 0 0 0 0 6 0 2 0 0 0 2 2 2 1 1 1 1 1 1 1 1 1 1 1
1 1 1 1 1 1 1 1 1 1 1 1 2 6 2 2 6 2 2 0 0 0 6 6 0 0 0 0 0 0 0 6 0 0 0 0 6 0 0 0 0 0 0 0 0 0 0 0 0 7 7 7 0 6 0 6 0 0 0 0 0 0 0 6 0 0 0 0 0 0 0 0 6 0 6 0 0 0 0 0 0 0 0 0 0 6 0 2 2 1 1 1 1 1 1 1 1 1 1 1
1 1 1 1 1 1 1 1 1 1 1 2 6 2 0 2 2 6 2 2 0 0 0 0 0 6 0 6 0 0 0 0 6 0 0 0 0 0 0 0 0 6 6 0 6 0 6 0 6 7 7 7 0 0 0 0 0 0 0 0 6 0 0 0 0 0 0 6 6 0 0 0 0 0 6 0 0 6 0 6 0 0 2 0 2 6 0 2 0 1 1 1 1 1 1 1 1 1 1 1
1 1 1 1 1 1 1 1 1 1 1 2 2 0 2 0 2 0 2 0 0 6 6 0 0 0 0 0 0 0 0 0 0 0 0 6 0 6 0 6 0 0 0 0 0 6 0 6 0 7 7 7 6 0 0 6 0 6 0 6 0 0 6 0 0 0 0 0 0 0 0 0 0 0 0 6 6 0 0 6 0 0 0 0 2 2 6 2 2 1 1 1 1 1 1 1 1 1 1 1
1 1 1 1 1 1 1 1 1 1 1 1 0 2 2 0 2 0 0 6 0 0 0 0 0 0 0 0 0 6 0 0 0 0 0 0 6 0 0 6 6 6 0 6 0 0 0 0 0 7 7 7 6 0 0 6 0 0 0 0 0 0 0 0 0 0 0 0 0 0 0 6 0 0 0 6 0 0 0 2 0 2 0 2 2 0 2 2 2 1 1 1 1 1 1 1 1 1 1 1
1 1 1 1 1 1 1 1 1 1 1 2 0 2 2 2 2 6 2 0 6 6 6 6 6 0 6 0 6 0 0 0 0 6 0 0 6 0 0 0 0 6 0 0 6 0 0 6 6 7 7 7 0 6 6 0 0 6 0 0 0 6 0 0 6 0 0 6 0 0 0 0 0 0 0 0 6 0 0 6 6 0 0 0 2 0 0 2 1 1 1 1 1 1 1 1 1 1 1 1
1 1 1 1 1 1 1 1 1 1 1 2 2 0 0 0 2 2 2 2 0 0 6 0 0 0 0 6 0 0 6 0 6 0 0 6 0 0 0 0 0 6 0 0 0 0 0 0 0 7 7 7 6 0 0 6 6 6 0 0 0 0 0 6 0 0 0 0 0 0 0 0 0 0 6 0 0 0 0 0 0 2 2 2 0 2 2 2 0 1 1 1 1 1 1 1 1 1 1 1
1 1 1 1 1 1 1 1 1 1 1 2 0 0 0 2 2 0 2 0 2 6 0 0 0 0 0 0 0 0 6 0 6 0 0 0 0 0 0 0 0 0 0 0 0 0 0 0 6 7 7 7 6 0 0 0 0 0 0 6 0 0 0 6 6 6 0 0 6 6 6 0 0 0 6 0 0 0 0 6 2 0 0 2 2 2 0 2 1 1 1 1 1 1 1 1 1 1 1 1
1 1 1 1 1 1 1 1 1 1 1 2 2 0 0 2 0 0 2 2 6 0 0 6 0 0 0 0 0 0 0 0 0 0 0 0 6 0 6 0 0 0 6 0 0 6 0 0 0 7 7 7 6 0 0 0 0 0 0 0 0 0 0 6 0 0 6 0 0 0 0 0 0 0 0 0 0 0 0 0 0 0 6 6 6 0 2 2 2 1 1 1 1 1 1 1 1 1 1 1
1 1 1 1 1 1 1 1 1 1 1 1 2 2 2 2 2 2 2 0 2 0 0 2 0 0 6 6 0 6 0 0 6 6 6 0 0 6 0 0 0 0 0 0 0 0 0 0 0 6 7 7 0 0 0 6 0 0 6 0 0 0 0 0 0 0 0 0 6 0 0 0 0 0 0 0 6 6 0 0 0 2 0 2 2 2 2 6 2 1 1 1 1 1 1 1 1 1 1 1
1 1 1 1 1 1 1 1 1 1 1 6 2 2 6 2 0 2 6 0 0 0 2 2 0 0 0 0 6 0 0 6 0 0 6 0 0 0 0 0 0 0 0 0 6 0 6 0 0 0 7 7 0 6 0 0 0 0 0 0 0 0 0 0 6 6 0 0 0 0 0 0 0 0 0 0 0 0 0 0 0 6 2 2 2 2 2 2 2 1 1 1 1 1 1 1 1 1 1 1
1 1 1 1 1 1 1 1 1 1 1 2 1 2 2 1 0 2 2 6 0 2 2 2 6 0 0 0 0 0 6 6 0 0 6 0 0 0 6 0 0 0 6 0 0 0 0 0 0 0 7 7 0 0 0 6 0 0 0 0 0 0 0 6 0 0 0 0 0 6 0 0 0 0 6 0 0 0 0 0 6 2 0 0 2 2 2 2 1 1 1 1 1 1 1 1 1 1 1 1
1 1 1 1 1 1 1 1 1 1 1 1 2 2 2 2 0 2 2 2 2 0 0 0 6 0 0 6 6 0 0 0 0 0 0 6 0 0 0 0 0 0 0 0 0 0 0 0 0 0 7 7 6 6 0 6 0 0 6 6 0 0 0 6 6 0 0 0 0 0 6 0 6 6 0 6 0 0 0 0 0 2 0 0 2 2 2 0 2 1 1 1 1 1 1 1 1 1 1 1
1 1 1 1 1 1 1 1 1 1 1 1 2 1 0 2 2 0 2 2 6 2 6 6 2 0 0 6 0 0 0 0 6 0 6 0 0 0 0 0 0 0 0 0 0 0 6 0 0 6 7 7 0 0 0 0 0 0 0 0 0 0 0 0 0 0 0 0 0 0 0 0 0 0 0 0 0 0 0 2 0 2 2 2 0 2 2 1 2 1 1 1 1 1 1 1 1 1 1 1
1 1 1 1 1 1 1 1 1 1 1 1 1 2 2 0 1 6 0 0 2 2 2 0 0 0 0 0 0 0 6 0 0 0 6 0 0 0 0 0 0 6 0 0 0 0 6 0 0 0 7 7 0 0 0 0 6 0 6 0 6 6 0 0 0 0 0 6 0 0 6 0 0 2 6 2 0 6 0 0 2 0 0 0 1 2 2 2 1 1 1 1 1 1 1 1 1 1 1 1
1 1 1 1 1 1 1 1 1 1 1 2 2 1 6 2 2 2 0 2 2 2 0 6 2 0 0 2 6 0 6 0 0 0 6 0 6 6 0 0 0 0 0 6 0 0 0 6 0 0 7 7 0 0 0 0 0 0 6 0 0 6 0 0 0 0 0 0 0 0 6 6 2 0 2 0 6 6 2 0 0 6 0 2 1 1 2 1 2 1 1 1 1 1 1 1 1 1 1 1
1 1 1 1 1 1 1 1 1 1 1 2 2 1 2 2 2 0 1 2 2 0 2 6 2 6 6 2 0 2 0 0 6 0 0 0 0 6 6 0 0 0 6 0 0 0 6 6 0 0 7 7 0 6 6 0 0 0 6 0 6 0 0 6 0 0 0 0 0 6 0 6 6 2 0 0 2 0 2 2 2 2 2 2 2 2 2 2 2 1 1 1 1 1 1 1 1 1 1 1
1 1 1 1 1 1 1 1 1 1 1 2 2 2 2 2 0 1 2 0 0 0 2 0 0 2 0 2 0 0 2 6 0 0 0 6 0 0 0 0 0 0 0 0 0 0 0 0 0 0 7 7 0 0 6 6 0 0 6 0 6 0 0 0 0 0 0 0 0 0 0 0 6 0 0 0 0 0 0 2 2 1 2 2 2 2 2 1 2 1 1 1 1 1 1 1 1 1 1 1
1 1 1 1 1 1 1 1 1 1 1 1 2 2 1 2 0 2 1 1 2 0 2 2 0 6 0 0 6 0 6 0 6 0 6 0 0 0 0 0 0 0 6 6 0 0 0 6 0 0 7 7 0 0 0 0 0 0 6 6 6 0 0 0 0 0 0 0 6 2 0 0 0 0 6 2 0 0 2 2 2 1 2 2 2 2 1 2 1 1 1 1 1 1 1 1 1 1 1 1
1 1 1 1 1 1 1 1 1 1 1 2 2 2 1 1 2 2 2 1 0 1 2 0 2 2 6 2 6 0 0 0 6 0 6 0 0 0 6 6 0 0 0 0 0 6 0 0 6 0 7 7 6 6 0 6 0 0 0 0 0 0 0 0 0 0 0 6 0 0 0 0 0 2 2 2 2 2 2 2 2 0 2 2 2 2 1 1 2 1 1 1 1 1 1 1 1 1 1 1
1 1 1 1 1 1 1 1 1 1 1 1 1 2 2 1 2 2 2 2 2 0 2 2 0 2 0 0 2 0 2 0 0 6 0 0 0 0 0 0 0 0 0 0 0 0 0 0 0 0 7 7 0 0 0 0 0 0 0 0 6 0 0 6 2 0 2 2 2 2 0 6 2 2 2 2 0 2 2 2 2 1 0 2 2 2 2 2 2 1 1 1 1 1 1 1 1 1 1 1
1 1 1 1 1 1 1 1 1 1 1 1 1 1 2 2 1 1 1 6 2 2 2 2 6 0 2 2 6 0 0 6 0 0 2 0 6 0 0 2 0 6 0 0 6 0 0 0 0 0 7 7 0 0 0 0 0 0 0 0 0 0 0 6 0 6 6 0 0 0 2 6 0 2 0 0 0 2 1 1 2 2 2 2 2 2 1 1 1 1 1 1 1 1 1 1 1 1 1 1
1 1 1 1 1 1 1 1 1 1 1 1 1 2 1 1 1 1 2 1 2 1 2 2 2 2 2 2 2 2 2 2 6 2 0 2 0 0 2 6 6 6 0 0 2 0 0 0 0 6 7 7 0 0 6 0 0 0 0 0 0 0 0 0 0 2 0 0 2 2 6 2 2 6 2 2 2 2 2 2 1 2 2 2 1 1 1 1 1 1 1 1 1 1 1 1 1 1 1 1
1 1 1 1 1 1 1 1 1 1 1 1 1 1 1 1 2 1 1 1 1 0 1 2 2 2 2 2 0 0 6 0 0 0 6 0 6 0 0 0 0 0 6 0 0 0 2 2 0 0 7 7 0 0 0 0 0 0 2 6 2 0 0 6 0 2 2 2 2 0 0 0 2 2 2 2 0 2 6 2 2 2 2 2 1 1 1 1 1 1 1 1 1 1 1 1 1 1 1 1
1 1 1 1 1 1 1 1 1 1 1 1 1 1 1 2 1 1 2 1 2 2 2 2 1 0 2 6 6 6 0 2 0 2 2 2 2 6 0 2 0 0 0 0 0 0 0 2 0 0 7 7 2 0 0 0 0 0 2 2 6 0 6 0 0 2 0 0 2 2 0 2 2 2 0 0 2 1 2 1 1 1 2 2 2 2 1 1 1 1 1 1 1 1 1 1 1 1 1 1
1 1 1 1 1 1 1 1 1 1 1 1 1 1 1 1 1 1 2 2 2 2 2 1 2 2 2 2 6 2 2 0 6 0 2 2 2 0 6 0 0 0 0 2 0 2 0 0 0 2 7 7 0 6 0 0 2 0 0 0 2 0 0 0 2 2 0 0 2 0 2 0 0 2 2 6 2 2 2 1 2 2 1 1 2 2 1 1 1 1 1 1 1 1 1 1 1 1 1 1
1 1 1 1 1 1 1 1 1 1 1 1 1 1 1 2 2 1 1 1 2 2 1 2 2 0 1 1 2 1 0 0 0 2 0 0 2 2 2 2 6 2 2 6 0 2 0 0 2 0 7 7 2 0 2 2 0 2 2 2 2 2 0 6 0 2 2 2 0 2 2 2 2 2 0 2 1 1 2 1 2 2 1 1 2 1 1 1 1 1 1 1 1 1 1 1 1 1 1 1
1 1 1 1 1 1 1 1 1 1 1 1 1 1 1 1 2 2 1 1 1 2 2 1 2 1 2 2 2 2 2 2 2 1 2 0 2 0 2 2 2 0 2 6 0 2 2 0 0 2 7 7 6 0 0 0 0 0 2 0 0 2 2 2 0 2 6 6 2 2 0 2 2 2 1 2 1 1 1 2 2 1 2 1 1 1 1 1 1 1 1 1 1 1 1 1 1 1 1 1
1 1 1 1 1 1 1 1 1 1 1 1 1 1 2 1 1 1 1 1 1 1 1 2 1 2 2 2 2 2 2 2 2 0 2 2 2 6 2 2 0 2 2 0 2 2 0 0 0 2 7 7 2 0 0 0 2 2 2 2 2 2 2 0 0 0 2 2 2 0 2 1 2 2 2 2 2 1 1 1 2 1 1 1 1 1 1 1 1 1 1 1 1 1 1 1 1 1 1 1
1 1 1 1 1 1 1 1 1 1 1 1 1 1 1 1 1 1 1 1 1 1 2 2 1 2 2 2 2 1 2 2 1 0 2 2 2 2 2 2 2 2 2 2 0 2 2 0 0 0 7 7 2 0 2 2 0 2 2 0 2 2 0 1 2 2 1 0 2 1 1 1 1 1 2 1 2 1 2 1 1 1 1 1 1 1 1 1 1 1 1 1 1 1 1 1 1 1 1 1
1 1 1 1 1 1 1 1 1 1 1 1 1 1 1 1 1 1 1 1 1 2 1 2 2 2 2 2 1 2 2 2 2 2 2 2 2 2 2 2 2 2 2 2 0 2 2 6 0 0 7 7 2 2 2 2 2 2 6 2 2 2 2 1 2 0 1 2 2 2 2 2 2 1 1 1 1 1 1 2 1 1 1 1 1 1 1 1 1 1 1 1 1 1 1 1 1 1 1 1
1 1 1 1 1 1 1 1 1 1 1 1 1 1 1 1 1 1 1 1 1 2 1 1 2 1 1 2 1 2 2 1 2 1 1 2 1 2 1 2 2 2 2 1 2 1 0 0 0 2 1 2 1 6 0 2 6 2 2 2 2 0 2 2 2 2 1 2 1 2 1 1 2 2 1 1 2 2 2 1 1 1 1 1 1 1 1 1 1 1 1 1 1 1 1 1 1 1 1 1
1 1 1 1 1 1 1 1 1 1 1 1 1 1 1 1 1 1 1 1 2 1 1 1 1 1 1 1 1 1 1 2 2 1 2 1 2 2 1 2 1 2 1 2 2 2 2 2 2 2 7 7 0 2 1 2 2 2 2 1 2 2 2 2 2 1 1 2 2 2 2 1 1 1 1 2 2 2 1 1 1 1 1 1 1 1 1 1 1 1 1 1 1 1 1 1 1 1 1 1
1 1 1 1 1 1 1 1 1 1 1 1 1 1 1 1 1 1 1 1 1 1 2 2 1 2 1 2 2 1 2 1 1 1 2 2 1 2 2 2 2 2 2 2 2 1 1 1 2 2 7 7 1 2 2 2 1 2 2 2 2 1 2 1 2 2 2 1 2 1 2 2 2 1 2 1 1 1 1 1 1 1 1 1 1 1 1 1 1 1 1 1 1 1 1 1 1 1 1 1
1 1 1 1 1 1 1 1 1 1 1 1 1 1 1 1 1 1 1 1 1 1 1 1 1 1 1 1 1 1 1 2 1 1 1 2 1 2 1 2 1 1 2 2 1 2 2 2 2 2 1 2 2 2 2 2 1 2 2 2 2 2 2 1 1 1 2 1 2 2 2 2 1 1 1 1 1 1 1 1 1 1 1 1 1 1 1 1 1 1 1 1 1 1 1 1 1 1 1 1
1 1 1 1 1 1 1 1 1 1 1 1 1 1 1 1 1 1 1 1 1 1 1 1 1 1 1 1 2 1 2 1 1 1 2 1 2 2 1 2 2 2 1 2 2 1 2 2 2 1 7 7 2 2 2 2 1 2 2 1 2 1 2 1 1 1 1 1 2 1 1 2 1 1 1 1 1 1 1 1 1 1 1 1 1 1 1 1 1 1 1 1 1 1 1 1 1 1 1 1
1 1 1 1 1 1 1 1 1 1 1 1 1 1 1 1 1 1 1 1 1 1 1 1 1 1 1 1 2 2 1 2 1 1 1 2 2 1 2 1 1 2 1 1 2 2 2 2 1 2 2 2 1 1 1 2 1 2 1 1 1 1 2 2 1 1 1 2 2 1 1 1 1 1 1 1 1 1 1 1 1 1 1 1 1 1 1 1 1 1 1 1 1 1 1 1 1 1 1 1
1 1 1 1 1 1 1 1 1 1 1 1 1 1 1 1 1 1 1 1 1 1 1 1 1 1 1 1 1 1 1 2 1 1 1 1 1 1 1 1 1 2 1 2 1 2 2 1 1 1 1 1 2 1 1 2 1 1 1 1 1 1 1 1 1 1 2 2 1 1 1 1 1 1 1 1 1 1 1 1 1 1 1 1 1 1 1 1 1 1 1 1 1 1 1 1 1 1 1 1
1 1 1 1 1 1 1 1 1 1 1 1 1 1 1 1 1 1 1 1 1 1 1 1 1 1 1 1 1 1 1 1 1 1 2 1 1 1 1 2 1 1 2 1 2 1 2 1 1 1 2 2 2 1 1 1 1 2 1 1 1 2 2 1 1 1 1 1 1 1 1 1 1 1 1 1 1 1 1 1 1 1 1 1 1 1 1 1 1 1 1 1 1 1 1 1 1 1 1 1
1 1 1 1 1 1 1 1 1 1 1 1 1 1 1 1 1 1 1 1 1 1 1 1 1 1 1 1 1 1 1 1 1 1 1 1 1 1 1 1 1 1 1 1 1 1 1 1 1 1 1 1 1 1 1 1 1 1 1 1 1 1 1 1 1 1 1 1 1 1 1 1 1 1 1 1 1 1 1 1 1 1 1 1 1 1 1 1 1 1 1 1 1 1 1 1 1 1 1 1
1 1 1 1 1 1 1 1 1 1 1 1 1 1 1 1 1 1 1 1 1 1 1 1 1 1 1 1 1 1 1 1 1 1 1 1 1 1 1 1 1 1 1 1 1 1 1 1 1 1 1 1 1 1 1 1 1 1 1 1 1 1 1 1 1 1 1 1 1 1 1 1 1 1 1 1 1 1 1 1 1 1 1 1 1 1 1 1 1 1 1 1 1 1 1 1 1 1 1 1
1 1 1 1 1 1 1 1 1 1 1 1 1 1 1 1 1 1 1 1 1 1 1 1 1 1 1 1 1 1 1 1 1 1 1 1 1 1 1 1 1 1 1 1 1 1 1 1 1 1 1 1 1 1 1 1 1 1 1 1 1 1 1 1 1 1 1 1 1 1 1 1 1 1 1 1 1 1 1 1 1 1 1 1 1 1 1 1 1 1 1 1 1 1 1 1 1 1 1 1
1 1 1 1 1 1 1 1 1 1 1 1 1 1 1 1 1 1 1 1 1 1 1 1 1 1 1 1 1 1 1 1 1 1 1 1 1 1 1 1 1 1 1 1 1 1 1 1 1 1 1 1 1 1 1 1 1 1 1 1 1 1 1 1 1 1 1 1 1 1 1 1 1 1 1 1 1 1 1 1 1 1 1 1 1 1 1 1 1 1 1 1 1 1 1 1 1 1 1 1
1 1 1 1 1 1 1 1 1 1 1 1 1 1 1 1 1 1 1 1 1 1 1 1 1 1 1 1 1 1 1 1 1 1 1 1 1 1 1 1 1 1 1 1 1 1 1 1 1 1 1 1 1 1 1 1 1 1 1 1 1 1 1 1 1 1 1 1 1 1 1 1 1 1 1 1 1 1 1 1 1 1 1 1 1 1 1 1 1 1 1 1 1 1 1 1 1 1 1 1
1 1 1 1 1 1 1 1 1 1 1 1 1 1 1 1 1 1 1 1 1 1 1 1 1 1 1 1 1 1 1 1 1 1 1 1 1 1 1 1 1 1 1 1 1 1 1 1 1 1 1 1 1 1 1 1 1 1 1 1 1 1 1 1 1 1 1 1 1 1 1 1 1 1 1 1 1 1 1 1 1 1 1 1 1 1 1 1 1 1 1 1 1 1 1 1 1 1 1 1
1 1 1 1 1 1 1 1 1 1 1 1 1 1 1 1 1 1 1 1 1 1 1 1 1 1 1 1 1 1 1 1 1 1 1 1 1 1 1 1 1 1 1 1 1 1 1 1 1 1 1 1 1 1 1 1 1 1 1 1 1 1 1 1 1 1 1 1 1 1 1 1 1 1 1 1 1 1 1 1 1 1 1 1 1 1 1 1 1 1 1 1 1 1 1 1 1 1 1 1